bleiben - blieb - ist geblieben
schreien - schrie - geschrien
schweigen - schwieg- geschwiegen
verzeihen - verzieh - verziehen
steigen - stieg - gestiegen
scheinen - schien - geschienen

reiten - ritt - ist geritten
schneiden - schnitt - geschnitten
streit - stritt - gestritten

fliegen - flog- ist geflogen
genießen - genoss- genossen
schießen - schss - geschossen
richen - roch - gerochen
verlieren - verlor - verloren
ziehen - zog - gezogen

finden - fand - gefunden
singen - sang- gesungen
trinken - trank - getrunken

beginnen - began - begonnen
gewinnen - gewann - gewonnen
schwimmen - schwamm - geschwommen

brechen - brach - gebrochen
helfen - half - geholfen
nehmen - nahm - genommen
sprechen - sprach - gesprochen
sterben - starb - ist gestorben
treffen - traf - getroffen
werfen - warf - geworfen
empfehlen - empfahl - empfohlen

essen - aß - gegessen
geben - gab - gegeben
geschehen - geschah - ist geschehen
lessen - las - gelesen
sehen - sah - gesehen
vergessen - vergaß - vergessen

bitten - bat - gebeten
liegen - lag - gelegen
sitzen - saß - gesessen

fahren - fuhr - gefahren
laden - lud - geladen
schaffen - schuf - geschaffen
schlagen - schlug - geschlagen
tragen - trug - getragen
wachsen - wuchs - ist gewachsen
waschen - wusch - gewaschen

braten - briet - gebraten
fallen - fiel - ist gefallen
halten - hielt - gehalten
lassen - ließ - gelassen
schlafen - schlief - geschlafen
fangen - fing - gefangen

heißen - hieß - gehießen
laufen - lief - ist gelaufen
rufen - rief - gerufen

lügen - log - gelogen
gehen - ging - ist gegangen
kommen - kam - ist gekommen
stehen - stand - gestanden

sein - war - ist gewesen
haben - hatte - gehabt
warden - wurde - ist geworden

Brennen - brannte - gebrannt
bringen - brachte - gebracht
denken - dachte - gedacht
kennen - kannte - gekannt
nennen - nannte - genannt
rennen - rannte - ist gerannt
wissen - wusste - gewusst
